0,1,1,0,0
1,1,0,2,1
0,1,4,3,1
0,1,2,1,0
8,10,1,1,0
0,0,9,8,0
