0,0,1,0,0,0
1,5,1,2,1,1
1,1,4,6,3,1
1,1,1,1,1,0
0,1,1,0,0,0
1,1,8,9,12,0
0,0,11,10,0,0
