0,1,0,0,0,0
0,1,1,1,1,1
0,1,3,1,0,0
0,0,2,2,1,0
0,1,1,4,8,0
1,1,1,8,9,0
0,1,0,10,0,0
