0,1,0,1,0
1,4,5,1,0
0,1,3,2,1
1,1,1,1,1
1,10,11,1,0
0,9,0,8,0
