0,1,0,0,0,0
0,1,1,9,12,8
0,1,1,3,11,11
0,0,6,2,1,0
0,1,5,5,1,0
1,1,1,1,1,0
0,1,0,1,0,0
