0,0,1,0,0,0
0,1,3,1,0,0
1,5,6,1,1,1
1,1,7,1,1,0
0,1,0,0,1,0
0,9,12,1,1,0
0,13,11,1,0,0
