0,0,0,0,0
0,1,1,0,1
0,2,3,0,0
0,4,1,1,0
0,1,8,1,0
0,0,10,9,0
